; JJR
ADJ_COMP	JJR
ADJ_COMP+CASE_DEF_ACC	JJR
ADJ_COMP+CASE_DEF_GEN	JJR
ADJ_COMP+CASE_DEF_NOM	JJR
ADJ_COMP+CASE_INDEF_ACC	JJR
ADJ_COMP+CASE_INDEF_GEN	JJR
ADJ_COMP+CASE_INDEF_NOM	JJR
ADJ_COMP+NSUFF_FEM_SG	JJR
ADJ_COMP+NSUFF_FEM_SG+CASE_DEF_NOM	JJR
ADJ_COMP+NSUFF_FEM_SG+CASE_DEF_GEN	JJR
ADJ_COMP+NSUFF_FEM_SG+CASE_INDEF_NOM	JJR
ADJ_COMP+NSUFF_FEM_PL+CASE_DEF_ACC	JJR
ADJ_COMP+NSUFF_FEM_PL+CASE_DEF_GEN	JJR
ADJ_COMP+NSUFF_MASC_DU_NOM	JJR
ADJ_COMP+NSUFF_MASC_PL	JJR
ADJ_COMP+NSUFF_MASC_PL_GEN	JJR
ADJ_COMP+NSUFF_MASC_PL_NOM	JJR
DET+ADJ_COMP	DT+JJR
DET+ADJ_COMP+CASE_DEF_ACC	DT+JJR
DET+ADJ_COMP+CASE_DEF_GEN	DT+JJR
DET+ADJ_COMP+CASE_DEF_NOM	DT+JJR
DET+ADJ_COMP+NSUFF_FEM_SG	DT+JJR
DET+ADJ_COMP+NSUFF_MASC_DU_ACC	DT+JJR
DET+ADJ_COMP+NSUFF_MASC_DU_GEN	DT+JJR
DET+ADJ_COMP+NSUFF_MASC_DU_NOM	DT+JJR
DET+ADJ_COMP+NSUFF_MASC_PL_GEN	DT+JJR
DET+ADJ_COMP+NSUFF_MASC_PL_NOM	DT+JJR

; NOUN_QUANT (nominal quantifier)
DET+NOUN_QUANT	DT+NOUN_QUANT
DET+NOUN_QUANT+CASE_DEF_ACC	DT+NOUN_QUANT
DET+NOUN_QUANT+CASE_DEF_GEN	DT+NOUN_QUANT
DET+NOUN_QUANT+CASE_DEF_NOM	DT+NOUN_QUANT
DET+NOUN_QUANT+NSUFF_FEM_SG	DT+NOUN_QUANT
DET+NOUN_QUANT+NSUFF_FEM_SG+CASE_DEF_ACC	DT+NOUN_QUANT
DET+NOUN_QUANT+NSUFF_FEM_SG+CASE_DEF_GEN	DT+NOUN_QUANT
DET+NOUN_QUANT+NSUFF_FEM_SG+CASE_DEF_NOM	DT+NOUN_QUANT
DET+NOUN_QUANT+NSUFF_MASC_DU_ACC	DT+NOUN_QUANT
DET+NOUN_QUANT+NSUFF_MASC_DU_GEN	DT+NOUN_QUANT
NOUN_QUANT	NOUN_QUANT
NOUN_QUANT+CASE_DEF_ACC	NOUN_QUANT
NOUN_QUANT+CASE_DEF_GEN	NOUN_QUANT
NOUN_QUANT+CASE_DEF_NOM	NOUN_QUANT
NOUN_QUANT+CASE_INDEF_ACC	NOUN_QUANT
NOUN_QUANT+CASE_INDEF_GEN	NOUN_QUANT
NOUN_QUANT+CASE_INDEF_NOM	NOUN_QUANT
NOUN_QUANT+NSUFF_FEM_DU	NOUN_QUANT
NOUN_QUANT+NSUFF_FEM_PL	NOUN_QUANT
NOUN_QUANT+NSUFF_FEM_SG	NOUN_QUANT
NOUN_QUANT+NSUFF_FEM_SG+CASE_DEF_ACC	NOUN_QUANT
NOUN_QUANT+NSUFF_FEM_SG+CASE_DEF_GEN	NOUN_QUANT
NOUN_QUANT+NSUFF_FEM_SG+CASE_DEF_NOM	NOUN_QUANT
NOUN_QUANT+NSUFF_FEM_SG+CASE_INDEF_ACC	NOUN_QUANT
NOUN_QUANT+NSUFF_FEM_SG+CASE_INDEF_GEN	NOUN_QUANT
NOUN_QUANT+NSUFF_FEM_SG+CASE_INDEF_NOM	NOUN_QUANT
NOUN_QUANT+NSUFF_MASC_DU_ACC	NOUN_QUANT
NOUN_QUANT+NSUFF_MASC_DU_ACC_POSS	NOUN_QUANT
NOUN_QUANT+NSUFF_MASC_DU_GEN	NOUN_QUANT
NOUN_QUANT+NSUFF_MASC_DU_GEN_POSS	NOUN_QUANT
NOUN_QUANT+NSUFF_MASC_DU_NOM_POSS	NOUN_QUANT

; ADJ_NUM (ordinal number/numerical adjective)
ADJ_NUM	ADJ_NUM
ADJ_NUM+CASE_DEF_ACC	ADJ_NUM
ADJ_NUM+CASE_DEF_GEN	ADJ_NUM
ADJ_NUM+CASE_DEF_NOM	ADJ_NUM
ADJ_NUM+CASE_INDEF_ACC	ADJ_NUM
ADJ_NUM+CASE_INDEF_GEN	ADJ_NUM
ADJ_NUM+CASE_INDEF_NOM	ADJ_NUM
ADJ_NUM+NSUFF_FEM_DU_GEN	ADJ_NUM
ADJ_NUM+NSUFF_FEM_SG	ADJ_NUM
ADJ_NUM+NSUFF_FEM_SG+CASE_DEF_ACC	ADJ_NUM
ADJ_NUM+NSUFF_FEM_SG+CASE_DEF_GEN	ADJ_NUM
ADJ_NUM+NSUFF_FEM_SG+CASE_DEF_NOM	ADJ_NUM
ADJ_NUM+NSUFF_FEM_SG+CASE_INDEF_ACC	ADJ_NUM
ADJ_NUM+NSUFF_FEM_SG+CASE_INDEF_GEN	ADJ_NUM
ADJ_NUM+NSUFF_FEM_SG+CASE_INDEF_NOM	ADJ_NUM
ADJ_NUM+NSUFF_MASC_DU_NOM_POSS	ADJ_NUM
ADJ_NUM+NSUFF_MASC_PL	ADJ_NUM
ADJ_NUM+NSUFF_MASC_PL_GEN	ADJ_NUM
ADJ_NUM+NSUFF_MASC_PL_ACC	ADJ_NUM
DET+ADJ_NUM	DT+ADJ_NUM
DET+ADJ_NUM+CASE_DEF_ACC	DT+ADJ_NUM
DET+ADJ_NUM+CASE_DEF_GEN	DT+ADJ_NUM
DET+ADJ_NUM+CASE_DEF_NOM	DT+ADJ_NUM
DET+ADJ_NUM+NSUFF_FEM_PL+CASE_DEF_NOM	DT+ADJ_NUM
DET+ADJ_NUM+NSUFF_FEM_PL+CASE_DEF_GEN	DT+ADJ_NUM
DET+ADJ_NUM+NSUFF_FEM_SG	DT+ADJ_NUM
DET+ADJ_NUM+NSUFF_FEM_SG+CASE_DEF_ACC	DT+ADJ_NUM
DET+ADJ_NUM+NSUFF_FEM_SG+CASE_DEF_GEN	DT+ADJ_NUM
DET+ADJ_NUM+NSUFF_FEM_SG+CASE_DEF_NOM	DT+ADJ_NUM
DET+ADJ_NUM+NSUFF_MASC_DU_ACC	DT+ADJ_NUM
DET+ADJ_NUM+NSUFF_MASC_DU_GEN	DT+ADJ_NUM
DET+ADJ_NUM+NSUFF_MASC_DU_NOM	DT+ADJ_NUM
DET+ADJ_NUM+NSUFF_MASC_PL	DT+ADJ_NUM
DET+ADJ_NUM+NSUFF_MASC_PL_ACC	DT+ADJ_NUM
DET+ADJ_NUM+NSUFF_MASC_PL_ACCGEN	DT+ADJ_NUM
DET+ADJ_NUM+NSUFF_MASC_PL_GEN	DT+ADJ_NUM
DET+ADJ_NUM+NSUFF_MASC_PL_NOM	DT+ADJ_NUM

; VBG (used here for verbal nouns/gerunds)
DET+NOUN.VN	DT+VBG
DET+NOUN.VN+CASE_DEF_ACC	DT+VBG
DET+NOUN.VN+CASE_DEF_GEN	DT+VBG
DET+NOUN.VN+CASE_DEF_NOM	DT+VBG
DET+NOUN.VN+NSUFF_FEM_DU_GEN	DT+VBG
DET+NOUN.VN+NSUFF_FEM_PL	DT+VBG
DET+NOUN.VN+NSUFF_FEM_SG	DT+VBG
DET+NOUN.VN+NSUFF_FEM_SG+CASE_DEF_ACC	DT+VBG
DET+NOUN.VN+NSUFF_FEM_SG+CASE_DEF_GEN	DT+VBG
DET+NOUN.VN+NSUFF_FEM_SG+CASE_DEF_NOM	DT+VBG
DET+NOUN.VN+NSUFF_MASC_DU_NOM	DT+VBG
DET+NOUN.VN+NSUFF_MASC_PL	DT+VBG
DET+NOUN.VN+NSUFF_MASC_PL_ACC	DT+VBG
DET+NOUN.VN+NSUFF_MASC_PL_ACCGEN	DT+VBG
DET+NOUN.VN+NSUFF_MASC_PL_GEN	DT+VBG
DET+NOUN.VN+NSUFF_MASC_PL_NOM	DT+VBG
NOUN.VN	VBG
NOUN.VN+CASE_DEF_ACC	VBG
NOUN.VN+CASE_DEF_GEN	VBG
NOUN.VN+CASE_DEF_NOM	VBG
NOUN.VN+CASE_INDEF_ACC	VBG
NOUN.VN+CASE_INDEF_GEN	VBG
NOUN.VN+CASE_INDEF_NOM	VBG
NOUN.VN+NSUFF_FEM_DU_ACC	VBG
NOUN.VN+NSUFF_FEM_PL	VBG
NOUN.VN+NSUFF_FEM_PL+CASE_DEF_ACC	VBG
NOUN.VN+NSUFF_FEM_PL+CASE_DEF_ACCGEN	VBG
NOUN.VN+NSUFF_FEM_PL+CASE_DEF_GEN	VBG
NOUN.VN+NSUFF_FEM_PL+CASE_DEF_NOM	VBG
NOUN.VN+NSUFF_FEM_SG	VBG
NOUN.VN+NSUFF_FEM_SG+CASE_DEF_ACC	VBG
NOUN.VN+NSUFF_FEM_SG+CASE_DEF_GEN	VBG
NOUN.VN+NSUFF_FEM_SG+CASE_DEF_NOM	VBG
NOUN.VN+NSUFF_FEM_SG+CASE_INDEF_ACC	VBG
NOUN.VN+NSUFF_FEM_SG+CASE_INDEF_GEN	VBG
NOUN.VN+NSUFF_FEM_SG+CASE_INDEF_NOM	VBG
NOUN.VN+NSUFF_MASC_DU_GEN	VBG
NOUN.VN+NSUFF_MASC_DU_NOM	VBG
NOUN.VN+NSUFF_MASC_DU_NOM_POSS	VBG
NOUN.VN+NSUFF_MASC_PL	VBG
NOUN.VN+NSUFF_MASC_PL_ACC	VBG
NOUN.VN+NSUFF_MASC_PL_ACCGEN	VBG
NOUN.VN+NSUFF_MASC_PL_GEN	VBG
NOUN.VN+NSUFF_MASC_PL_NOM	VBG

; VN (used for verbal nominals/active or passive participles)
ADJ.VN	VN
ADJ.VN+CASE_DEF_ACC	VN
ADJ.VN+CASE_DEF_GEN	VN
ADJ.VN+CASE_DEF_NOM	VN
ADJ.VN+CASE_INDEF_ACC	VN
ADJ.VN+CASE_INDEF_GEN	VN
ADJ.VN+CASE_INDEF_NOM	VN
ADJ.VN+NSUFF_FEM_DU_ACC	VN
ADJ.VN+NSUFF_FEM_DU_NOM	VN
ADJ.VN+NSUFF_FEM_PL	VN
ADJ.VN+NSUFF_FEM_PL+CASE_INDEF_NOM	VN
ADJ.VN+NSUFF_FEM_PL+CASE_INDEF_GEN	VN
ADJ.VN+NSUFF_FEM_SG	VN
ADJ.VN+NSUFF_FEM_SG+CASE_DEF_ACC	VN
ADJ.VN+NSUFF_FEM_SG+CASE_DEF_GEN	VN
ADJ.VN+NSUFF_FEM_SG+CASE_DEF_NOM	VN
ADJ.VN+NSUFF_FEM_SG+CASE_INDEF_ACC	VN
ADJ.VN+NSUFF_FEM_SG+CASE_INDEF_GEN	VN
ADJ.VN+NSUFF_FEM_SG+CASE_INDEF_NOM	VN
ADJ.VN+NSUFF_MASC_DU_ACC	VN
ADJ.VN+NSUFF_MASC_DU_NOM	VN
ADJ.VN+NSUFF_MASC_DU_NOM_POSS	VN
ADJ.VN+NSUFF_MASC_DU_GEN	VN
ADJ.VN+NSUFF_MASC_PL	VN
ADJ.VN+NSUFF_MASC_PL_ACC	VN
ADJ.VN+NSUFF_MASC_PL_ACCGEN	VN
ADJ.VN+NSUFF_MASC_PL_GEN	VN
ADJ.VN+NSUFF_MASC_PL_GEN_POSS	VN
ADJ.VN+NSUFF_MASC_PL_NOM	VN
DET+ADJ.VN	DT+VN
DET+ADJ.VN+CASE_DEF_ACC	DT+VN
DET+ADJ.VN+CASE_DEF_GEN	DT+VN
DET+ADJ.VN+CASE_DEF_NOM	DT+VN
DET+ADJ.VN+NSUFF_FEM_DU	DT+VN
DET+ADJ.VN+NSUFF_FEM_DU_ACC	DT+VN
DET+ADJ.VN+NSUFF_FEM_DU_GEN	DT+VN
DET+ADJ.VN+NSUFF_FEM_DU_NOM	DT+VN
DET+ADJ.VN+NSUFF_MASC_PL	DT+VN
DET+ADJ.VN+NSUFF_FEM_PL	DT+VN
DET+ADJ.VN+NSUFF_FEM_PL+CASE_DEF_GEN	DT+VN
DET+ADJ.VN+NSUFF_FEM_PL+CASE_DEF_NOM	DT+VN
DET+ADJ.VN+NSUFF_FEM_SG	DT+VN
DET+ADJ.VN+NSUFF_FEM_SG+CASE_DEF_ACC	DT+VN
DET+ADJ.VN+NSUFF_FEM_SG+CASE_DEF_GEN	DT+VN
DET+ADJ.VN+NSUFF_FEM_SG+CASE_DEF_NOM	DT+VN
DET+ADJ.VN+NSUFF_MASC_DU_ACC	DT+VN
DET+ADJ.VN+NSUFF_MASC_DU_GEN	DT+VN
DET+ADJ.VN+NSUFF_MASC_DU_NOM	DT+VN
DET+ADJ.VN+NSUFF_MASC_PL_ACC	DT+VN
DET+ADJ.VN+NSUFF_MASC_PL_ACCGEN	DT+VN
DET+ADJ.VN+NSUFF_MASC_PL_GEN	DT+VN
DET+ADJ.VN+NSUFF_MASC_PL_GEN_POSS	DT+VN
DET+ADJ.VN+NSUFF_MASC_PL_NOM	DT+VN

; NN
ABBREV	NN
DET+ABBREV	DT+NN
DET+FOREIGN	DT+NN
DET+NOUN	DT+NN
DET+NOUN+CASE_DEF_ACC	DT+NN
DET+NOUN+CASE_DEF_GEN	DT+NN
DET+NOUN+CASE_DEF_NOM	DT+NN
DET+NOUN+NSUFF_FEM_SG	DT+NN
DET+NOUN+NSUFF_FEM_SG+CASE_DEF_ACC	DT+NN
DET+NOUN+NSUFF_FEM_SG+CASE_DEF_GEN	DT+NN
DET+NOUN+NSUFF_FEM_SG+CASE_DEF_NOM	DT+NN
DIALECT	NN
DET+DIALECT	DT+NN
FOREIGN	NN
GRAMMAR_PROBLEM	NN
LATIN	NN
NO_SOL	NN
NOUN	NN
NOUN+CASE_DEF_ACC	NN
NOUN+CASE_DEF_GEN	NN
NOUN+CASE_DEF_NOM	NN
NOUN+CASE_INDEF_ACC	NN
NOUN+CASE_INDEF_GEN	NN
NOUN+CASE_INDEF_NOM	NN
NOUN+NSUFF_FEM_SG	NN
NOUN+NSUFF_FEM_SG+CASE_DEF_ACC	NN
NOUN+NSUFF_FEM_SG+CASE_DEF_GEN	NN
NOUN+NSUFF_FEM_SG+CASE_DEF_NOM	NN
NOUN+NSUFF_FEM_SG+CASE_INDEF_ACC	NN
NOUN+NSUFF_FEM_SG+CASE_INDEF_GEN	NN
NOUN+NSUFF_FEM_SG+CASE_INDEF_NOM	NN
NOUN+NSUFF_MASC_SG_ACC_INDEF	NN
TRANSLIT_ERR	NN
TYPO	NN
DET+TYPO	DT+NN
DET+TRANSERR	DT+NN

; NNS
DET+NOUN+NSUFF_FEM_DU	DT+NNS
DET+NOUN+NSUFF_FEM_DU_ACC	DT+NNS
DET+NOUN+NSUFF_FEM_DU_ACCGEN	DT+NNS
DET+NOUN+NSUFF_FEM_DU_GEN	DT+NNS
DET+NOUN+NSUFF_FEM_DU_GEN_POSS	DT+NNS
DET+NOUN+NSUFF_FEM_DU_NOM	DT+NNS
DET+NOUN+NSUFF_FEM_PL	DT+NNS
DET+NOUN+NSUFF_FEM_PL+CASE_DEF_ACC	DT+NNS
DET+NOUN+NSUFF_FEM_PL+CASE_DEF_ACCGEN	DT+NNS
DET+NOUN+NSUFF_FEM_PL+CASE_DEF_GEN	DT+NNS
DET+NOUN+NSUFF_FEM_PL+CASE_DEF_NOM	DT+NNS
DET+NOUN+NSUFF_MASC_DU	DT+NNS
DET+NOUN+NSUFF_MASC_DU_ACC	DT+NNS
DET+NOUN+NSUFF_MASC_DU_ACCGEN	DT+NNS
DET+NOUN+NSUFF_MASC_DU_GEN	DT+NNS
DET+NOUN+NSUFF_MASC_DU_GEN_POSS	DT+NNS
DET+NOUN+NSUFF_MASC_DU_NOM	DT+NNS
DET+NOUN+NSUFF_MASC_PL	DT+NNS
DET+NOUN+NSUFF_MASC_PL_ACC	DT+NNS
DET+NOUN+NSUFF_MASC_PL_ACC_POSS	DT+NNS
DET+NOUN+NSUFF_MASC_PL_ACCGEN	DT+NNS
DET+NOUN+NSUFF_MASC_PL_GEN	DT+NNS
DET+NOUN+NSUFF_MASC_PL_GEN_POSS	DT+NNS
DET+NOUN+NSUFF_MASC_PL_NOM	DT+NNS
NOUN+NSUFF_FEM_DU	NNS
NOUN+NSUFF_FEM_DU_ACC	NNS
NOUN+NSUFF_FEM_DU_ACCGEN	NNS
NOUN+NSUFF_FEM_DU_ACCGEN_POSS	NNS
NOUN+NSUFF_FEM_DU_ACC_POSS	NNS
NOUN+NSUFF_FEM_DU_GEN	NNS
NOUN+NSUFF_FEM_DU_GEN_POSS	NNS
NOUN+NSUFF_FEM_DU_NOM	NNS
NOUN+NSUFF_FEM_DU_NOM_POSS	NNS
NOUN+NSUFF_FEM_PL	NNS
NOUN+NSUFF_FEM_PL+CASE_DEF_ACC	NNS
NOUN+NSUFF_FEM_PL+CASE_DEF_ACCGEN	NNS
NOUN+NSUFF_FEM_PL+CASE_DEF_GEN	NNS
NOUN+NSUFF_FEM_PL+CASE_DEF_NOM	NNS
NOUN+NSUFF_FEM_PL+CASE_INDEF_ACC	NNS
NOUN+NSUFF_FEM_PL+CASE_INDEF_ACCGEN	NNS
NOUN+NSUFF_FEM_PL+CASE_INDEF_GEN	NNS
NOUN+NSUFF_FEM_PL+CASE_INDEF_NOM	NNS
NOUN+NSUFF_MASC_DU	NNS
NOUN+NSUFF_MASC_DU_ACC	NNS
NOUN+NSUFF_MASC_DU_ACC_POSS	NNS
NOUN+NSUFF_MASC_DU_ACCGEN	NNS
NOUN+NSUFF_MASC_DU_ACCGEN_POSS	NNS
NOUN+NSUFF_MASC_DU_GEN	NNS
NOUN+NSUFF_MASC_DU_GEN_POSS	NNS
NOUN+NSUFF_MASC_DU_NOM	NNS
NOUN+NSUFF_MASC_DU_NOM_POSS	NNS
NOUN+NSUFF_MASC_PL	NNS
NOUN+NSUFF_MASC_PL_ACC	NNS
NOUN+NSUFF_MASC_PL_ACC_POSS	NNS
NOUN+NSUFF_MASC_PL_ACCGEN	NNS
NOUN+NSUFF_MASC_PL_ACCGEN_POSS	NNS
NOUN+NSUFF_MASC_PL_GEN	NNS
NOUN+NSUFF_MASC_PL_GEN_POSS	NNS
NOUN+NSUFF_MASC_PL_NOM	NNS
NOUN+NSUFF_MASC_PL_NOM_POSS	NNS

; NNP
DET+NOUN_PROP	DT+NNP
DET+NOUN_PROP+CASE_DEF_ACC	DT+NNP
DET+NOUN_PROP+CASE_DEF_GEN	DT+NNP
DET+NOUN_PROP+CASE_DEF_NOM	DT+NNP
DET+NOUN_PROP+NSUFF_FEM_DU_ACC	DT+NNP
DET+NOUN_PROP+NSUFF_FEM_SG	DT+NNP
DET+NOUN_PROP+NSUFF_FEM_SG+CASE_DEF_ACC	DT+NNP
DET+NOUN_PROP+NSUFF_FEM_SG+CASE_DEF_GEN	DT+NNP
DET+NOUN_PROP+NSUFF_FEM_SG+CASE_DEF_NOM	DT+NNP
NOUN_PROP	NNP
NOUN_PROP+CASE_DEF_ACC	NNP
NOUN_PROP+CASE_DEF_GEN	NNP
NOUN_PROP+CASE_DEF_NOM	NNP
NOUN_PROP+CASE_INDEF_ACC	NNP
NOUN_PROP+CASE_INDEF_GEN	NNP
NOUN_PROP+CASE_INDEF_NOM	NNP
NOUN_PROP+NSUFF_FEM_SG	NNP
NOUN_PROP+NSUFF_FEM_SG+CASE_DEF_ACC	NNP
NOUN_PROP+NSUFF_FEM_SG+CASE_DEF_GEN	NNP
NOUN_PROP+NSUFF_FEM_SG+CASE_DEF_NOM	NNP
NOUN_PROP+NSUFF_FEM_SG+CASE_INDEF_ACC	NNP
NOUN_PROP+NSUFF_FEM_SG+CASE_INDEF_GEN	NNP
NOUN_PROP+NSUFF_FEM_SG+CASE_INDEF_NOM	NNP

; NNPS
DET+NOUN_PROP+NSUFF_FEM_DU_GEN	DT+NNPS
DET+NOUN_PROP+NSUFF_FEM_DU_NOM	DT+NNPS
DET+NOUN_PROP+NSUFF_FEM_PL	DT+NNPS
DET+NOUN_PROP+NSUFF_FEM_PL+CASE_DEF_ACCGEN	DT+NNPS
DET+NOUN_PROP+NSUFF_FEM_PL+CASE_DEF_GEN	DT+NNPS
DET+NOUN_PROP+NSUFF_MASC_DU_ACC	DT+NNPS
DET+NOUN_PROP+NSUFF_MASC_DU_ACCGEN	DT+NNPS
DET+NOUN_PROP+NSUFF_MASC_DU_GEN	DT+NNPS
DET+NOUN_PROP+NSUFF_MASC_DU_NOM	DT+NNPS
DET+NOUN_PROP+NSUFF_MASC_PL	DT+NNPS
DET+NOUN_PROP+NSUFF_MASC_PL_ACC	DT+NNPS
DET+NOUN_PROP+NSUFF_MASC_PL_GEN	DT+NNPS
DET+NOUN_PROP+NSUFF_MASC_PL_NOM	DT+NNPS
NOUN_PROP+NSUFF_FEM_PL	NNPS
NOUN_PROP+NSUFF_FEM_PL+CASE_DEF_GEN	NNPS
NOUN_PROP+NSUFF_FEM_PL+CASE_INDEF_ACCGEN	NNPS
NOUN_PROP+NSUFF_FEM_PL+CASE_INDEF_GEN	NNPS
NOUN_PROP+NSUFF_MASC_DU_GEN	NNPS
NOUN_PROP+NSUFF_MASC_PL_GEN_POSS	NNPS
NOUN_PROP+NSUFF_MASC_PL_NOM	NNPS

; JJ
ADJ	JJ
ADJ+CASE_DEF_ACC	JJ
ADJ+CASE_DEF_GEN	JJ
ADJ+CASE_DEF_NOM	JJ
ADJ+CASE_INDEF_ACC	JJ
ADJ+CASE_INDEF_GEN	JJ
ADJ+CASE_INDEF_NOM	JJ
ADJ+NSUFF_FEM_DU	JJ
ADJ+NSUFF_FEM_DU_ACC	JJ
ADJ+NSUFF_FEM_DU_ACCGEN	JJ
ADJ+NSUFF_FEM_DU_GEN	JJ
ADJ+NSUFF_FEM_DU_GEN_POSS	JJ
ADJ+NSUFF_FEM_DU_NOM	JJ
ADJ+NSUFF_FEM_DU_NOM_POSS	JJ
ADJ+NSUFF_FEM_PL	JJ
ADJ+NSUFF_FEM_PL+CASE_DEF_ACC	JJ
ADJ+NSUFF_FEM_PL+CASE_DEF_ACCGEN	JJ
ADJ+NSUFF_FEM_PL+CASE_DEF_GEN	JJ
ADJ+NSUFF_FEM_PL+CASE_DEF_NOM	JJ
ADJ+NSUFF_FEM_PL+CASE_INDEF_ACC	JJ
ADJ+NSUFF_FEM_PL+CASE_INDEF_ACCGEN	JJ
ADJ+NSUFF_FEM_PL+CASE_INDEF_GEN	JJ
ADJ+NSUFF_FEM_PL+CASE_INDEF_NOM	JJ
ADJ+NSUFF_FEM_SG	JJ
ADJ+NSUFF_FEM_SG+CASE_DEF_ACC	JJ
ADJ+NSUFF_FEM_SG+CASE_DEF_GEN	JJ
ADJ+NSUFF_FEM_SG+CASE_DEF_NOM	JJ
ADJ+NSUFF_FEM_SG+CASE_INDEF_ACC	JJ
ADJ+NSUFF_FEM_SG+CASE_INDEF_GEN	JJ
ADJ+NSUFF_FEM_SG+CASE_INDEF_NOM	JJ
ADJ+NSUFF_MASC_DU	JJ
ADJ+NSUFF_MASC_DU_ACC	JJ
ADJ+NSUFF_MASC_DU_ACC_POSS	JJ
ADJ+NSUFF_MASC_DU_ACCGEN	JJ
ADJ+NSUFF_MASC_DU_ACCGEN_POSS	JJ
ADJ+NSUFF_MASC_DU_GEN	JJ
ADJ+NSUFF_MASC_DU_GEN_POSS	JJ
ADJ+NSUFF_MASC_DU_NOM	JJ
ADJ+NSUFF_MASC_DU_NOM_POSS	JJ
ADJ+NSUFF_MASC_PL	JJ
ADJ+NSUFF_MASC_PL_ACC	JJ
ADJ+NSUFF_MASC_PL_ACC_POSS	JJ
ADJ+NSUFF_MASC_PL_ACCGEN	JJ
ADJ+NSUFF_MASC_PL_ACCGEN_POSS	JJ
ADJ+NSUFF_MASC_PL_GEN	JJ
ADJ+NSUFF_MASC_PL_GEN_POSS	JJ
ADJ+NSUFF_MASC_PL_NOM	JJ
ADJ+NSUFF_MASC_PL_NOM_POSS	JJ
DET+ADJ	DT+JJ
DET+ADJ+CASE_DEF_ACC	DT+JJ
DET+ADJ+CASE_DEF_GEN	DT+JJ
DET+ADJ+CASE_DEF_NOM	DT+JJ
DET+ADJ+NSUFF_FEM_DU	DT+JJ
DET+ADJ+NSUFF_FEM_DU_ACC	DT+JJ
DET+ADJ+NSUFF_FEM_DU_ACCGEN	DT+JJ
DET+ADJ+NSUFF_FEM_DU_ACCGEN_POSS	DT+JJ
DET+ADJ+NSUFF_FEM_DU_GEN	DT+JJ
DET+ADJ+NSUFF_FEM_DU_NOM	DT+JJ
DET+ADJ+NSUFF_FEM_PL	DT+JJ
DET+ADJ+NSUFF_FEM_PL+CASE_DEF_ACC	DT+JJ
DET+ADJ+NSUFF_FEM_PL+CASE_DEF_ACCGEN	DT+JJ
DET+ADJ+NSUFF_FEM_PL+CASE_DEF_GEN	DT+JJ
DET+ADJ+NSUFF_FEM_PL+CASE_DEF_NOM	DT+JJ
DET+ADJ+NSUFF_FEM_SG	DT+JJ
DET+ADJ+NSUFF_FEM_SG+CASE_DEF_ACC	DT+JJ
DET+ADJ+NSUFF_FEM_SG+CASE_DEF_GEN	DT+JJ
DET+ADJ+NSUFF_FEM_SG+CASE_DEF_NOM	DT+JJ
DET+ADJ+NSUFF_MASC_DU_ACC	DT+JJ
DET+ADJ+NSUFF_MASC_DU_ACCGEN	DT+JJ
DET+ADJ+NSUFF_MASC_DU_GEN	DT+JJ
DET+ADJ+NSUFF_MASC_DU_NOM	DT+JJ
DET+ADJ+NSUFF_MASC_PL	DT+JJ
DET+ADJ+NSUFF_MASC_PL_ACC	DT+JJ
DET+ADJ+NSUFF_MASC_PL_ACC_POSS	DT+JJ
DET+ADJ+NSUFF_MASC_PL_ACCGEN	DT+JJ
DET+ADJ+NSUFF_MASC_PL_ACCGEN_POSS	DT+JJ
DET+ADJ+NSUFF_MASC_PL_GEN	DT+JJ
DET+ADJ+NSUFF_MASC_PL_GEN_POSS	DT+JJ
DET+ADJ+NSUFF_MASC_PL_NOM	DT+JJ

; RB
ADV	RB
ADV+CASE_INDEF_ACC	RB

; CC
CONJ	CC

; DT
DEM_PRON	DT
DEM_PRON_F	DT
DEM_PRON_FD	DT
DEM_PRON_FP	DT
DEM_PRON_FS	DT
DEM_PRON_MD	DT
DEM_PRON_MP	DT
DEM_PRON_MS	DT
DEM_PRON_P	DT
DET	DT

; RP
CONNEC_PART	RP
EMPHATIC_PART	RP
FOCUS_PART	RP
FUT_PART	RP
INTERROG_PART	RP
JUS_PART	RP
NEG_PART	RP
PART	RP
PROG_PART	RP
RC_PART	RP
RESTRIC_PART	RP
VERB_PART	RP
VOC_PART	RP

; IN
PREP	IN
SUB_CONJ	IN

; VBP (old present tense tag used for imperfect verbs)
FUT+IV1P+IV+IVSUFF_MOOD:I	VBP
FUT+IV1S+IV+IVSUFF_MOOD:I	VBP
FUT+IV2MP+IV+IVSUFF_SUBJ:MP_MOOD:I	VBP
FUT+IV2MS+IV+IVSUFF_MOOD:I	VBP
FUT+IV3FD+IV+IVSUFF_SUBJ:D_MOOD:I	VBP
FUT+IV3FS+IV+IVSUFF_MOOD:I	VBP
FUT+IV3MD+IV+IVSUFF_SUBJ:D_MOOD:I	VBP
FUT+IV3MP+IV+IVSUFF_SUBJ:MP_MOOD:I	VBP
FUT+IV3MS+IV+IVSUFF_MOOD:I	VBP
IV	VBP
IV+IVSUFF_SUBJ:3FS	VBP
IV+IVSUFF_SUBJ:MD_MOOD:I	VBP
IV1P+IV	VBP
IV1P+IV+IVSUFF_MOOD:I	VBP
IV1P+IV+IVSUFF_MOOD:J	VBP
IV1P+IV+IVSUFF_MOOD:S	VBP
IV1P+IV+IVSUFF_SUBJ:P	VBP
IV1S+IV	VBP
IV1S+IV+IVSUFF_MOOD:I	VBP
IV1S+IV+IVSUFF_MOOD:J	VBP
IV1S+IV+IVSUFF_MOOD:S	VBP
IV2D+IV+IVSUFF_SUBJ:D_MOOD:I	VBP
IV2D+IV+IVSUFF_SUBJ:D_MOOD:SJ	VBP
IV2FP+IV+IVSUFF_SUBJ:FP	VBP
IV2FS+IV	VBP
IV2FS+IV+IVSUFF_SUBJ:2FS	VBP
IV2FS+IV+IVSUFF_SUBJ:2FS_MOOD:I	VBP
IV2FS+IV+IVSUFF_SUBJ:2FS_MOOD:SJ	VBP
IV2MP+IV+IVSUFF_SUBJ:P	VBP
IV2MP+IV+IVSUFF_SUBJ:MP	VBP
IV2MP+IV+IVSUFF_SUBJ:MP_MOOD:I	VBP
IV2MP+IV+IVSUFF_SUBJ:MP_MOOD:SJ	VBP
IV2MS+IV	VBP
IV2MS+IV+IVSUFF_MOOD:I	VBP
IV2MS+IV+IVSUFF_MOOD:J	VBP
IV2MS+IV+IVSUFF_MOOD:S	VBP
IV2P+IV	VBP
IV2P+IV+IVSUFF_SUBJ:P	VBP
IV3FD+IV+IVSUFF_SUBJ:D_MOOD:I	VBP
IV3FD+IV+IVSUFF_SUBJ:D_MOOD:SJ	VBP
IV3FP+IV	VBP
IV3FP+IV+IVSUFF_SUBJ:FP	VBP
IV3FS+IV	VBP
IV3FS+IV+IVSUFF_MOOD:I	VBP
IV3FS+IV+IVSUFF_MOOD:J	VBP
IV3FS+IV+IVSUFF_MOOD:S	VBP
IV3FS+IV+IVSUFF_SUBJ:3FS	VBP
IV3MD+IV+IVSUFF_SUBJ:D_MOOD:I	VBP
IV3MD+IV+IVSUFF_SUBJ:D_MOOD:SJ	VBP
IV3MP+IV	VBP
IV3MP+IV+IVSUFF_MOOD:I	VBP
IV3MP+IV+IVSUFF_MOOD:S	VBP
IV3MP+IV+IVSUFF_SUBJ:P	VBP
IV3MP+IV+IVSUFF_SUBJ:MP	VBP
IV3MP+IV+IVSUFF_SUBJ:3MP_MOOD:I	VBP
IV3MP+IV+IVSUFF_SUBJ:MP_MOOD:I	VBP
IV3MP+IV+IVSUFF_SUBJ:MP_MOOD:SJ	VBP
IV3MS+IV	VBP
IV3MS+IV+IVSUFF_MOOD:I	VBP
IV3MS+IV+IVSUFF_MOOD:J	VBP
IV3MS+IV+IVSUFF_MOOD:S	VBP
IV3P+IV	VBP
IV3P+IV+IVSUFF_SUBJ:P	VBP
JUS+IV1P+IV+IVSUFF_MOOD:J	VBP
JUS+IV2FS+IV+IVSUFF_SUBJ:2FS_MOOD:SJ	VBP
JUS+IV2MS+IV+IVSUFF_MOOD:J	VBP
JUS+IV3FS+IV+IVSUFF_MOOD:J	VBP
JUS+IV3MP+IV+IVSUFF_MOOD:J	VBP
JUS+IV3MP+IV+IVSUFF_SUBJ:MP_MOOD:SJ	VBP
JUS+IV3MS+IV+IVSUFF_MOOD:J	VBP
PSEUDO_VERB	VBP
VERB	VBP

; VBN (passive verb, using old past participle tag)
FUT+IV3FS+IV_PASS+IVSUFF_MOOD:I	VBN
FUT+IV3MD+IV_PASS+IVSUFF_SUBJ:D_MOOD:I	VBN
FUT+IV3MP+IV_PASS+IVSUFF_SUBJ:MP_MOOD:I	VBN
FUT+IV3MS+IV_PASS+IVSUFF_MOOD:I	VBN
FUT+IV3MS+IV_PASS+IVSUFF_MOOD:S	VBN
IV1P+IV_PASS	VBN
IV1P+IV_PASS+IVSUFF_MOOD:I	VBN
IV1P+IV_PASS+IVSUFF_MOOD:J	VBN
IV1P+IV_PASS+IVSUFF_MOOD:S	VBN
IV1S+IV_PASS	VBN
IV1S+IV_PASS+IVSUFF_MOOD:I	VBN
IV1S+IV_PASS+IVSUFF_MOOD:J	VBN
IV1S+IV_PASS+IVSUFF_MOOD:S	VBN
IV2FS+IV_PASS+IVSUFF_MOOD:I	VBN
IV2FS+IV_PASS+IVSUFF_MOOD:S	VBN
IV2FS+IV_PASS+IVSUFF_SUBJ:2FS	VBN
IV2FS+IV_PASS+IVSUFF_SUBJ:2FS_MOOD:SJ	VBN
IV2MP+IV_PASS+IVSUFF_SUBJ:MP_MOOD:I	VBN
IV2MS+IV_PASS	VBN
IV2MS+IV_PASS+IVSUFF_MOOD:I	VBN
IV2MS+IV_PASS+IVSUFF_MOOD:J	VBN
IV2MS+IV_PASS+IVSUFF_MOOD:S	VBN
IV2P+IV_PASS+IVSUFF_SUBJ:P	VBN
IV3FD+IV_PASS+IVSUFF_SUBJ:D_MOOD:I	VBN
IV3FP+IV_PASS+IVSUFF_MOOD:S	VBN
IV3FS+IV_PASS	VBN
IV3FS+IV_PASS+IVSUFF_MOOD:I	VBN
IV3FS+IV_PASS+IVSUFF_MOOD:J	VBN
IV3FS+IV_PASS+IVSUFF_MOOD:S	VBN
IV3MD+IV_PASS+IVSUFF_SUBJ:D_MOOD:I	VBN
IV3MD+IV_PASS+IVSUFF_SUBJ:D_MOOD:SJ	VBN
IV3MP+IV_PASS+IVSUFF_MOOD:I	VBN
IV3MP+IV_PASS+IVSUFF_SUBJ:MP	VBN
IV3MP+IV_PASS+IVSUFF_SUBJ:MP_MOOD:I	VBN
IV3MP+IV_PASS+IVSUFF_SUBJ:MP_MOOD:SJ	VBN
IV3MS+IV_PASS	VBN
IV3MS+IV_PASS+IVSUFF_MOOD:I	VBN
IV3MS+IV_PASS+IVSUFF_MOOD:J	VBN
IV3MS+IV_PASS+IVSUFF_MOOD:S	VBN
IV3P+IV_PASS+IVSUFF_SUBJ:P	VBN
IV_PASS	VBN
JUS+IV3MS+IV_PASS+IVSUFF_MOOD:J	VBN
PV_PASS	VBN
PV_PASS+PVSUFF_SUBJ:1P	VBN
PV_PASS+PVSUFF_SUBJ:1S	VBN
PV_PASS+PVSUFF_SUBJ:2FS	VBN
PV_PASS+PVSUFF_SUBJ:2MP	VBN
PV_PASS+PVSUFF_SUBJ:2MS	VBN
PV_PASS+PVSUFF_SUBJ:2P	VBN
PV_PASS+PVSUFF_SUBJ:3FD	VBN
PV_PASS+PVSUFF_SUBJ:3FP	VBN
PV_PASS+PVSUFF_SUBJ:3FS	VBN
PV_PASS+PVSUFF_SUBJ:3MD	VBN
PV_PASS+PVSUFF_SUBJ:3MP	VBN
PV_PASS+PVSUFF_SUBJ:3MS	VBN
PV_PASS+PVSUFF_SUBJ:3P	VBN

; UH
INTERJ	UH

; PRP
CVSUFF_DO:1P	PRP
CVSUFF_DO:1S	PRP
CVSUFF_DO:2MP	PRP
CVSUFF_DO:2MS	PRP
CVSUFF_DO:3FS	PRP
CVSUFF_DO:3MP	PRP
CVSUFF_DO:3MS	PRP
CVSUFF_DO:3P	PRP
IVSUFF_DO:1P	PRP
IVSUFF_DO:1S	PRP
IVSUFF_DO:2FS	PRP
IVSUFF_DO:2MP	PRP
IVSUFF_DO:2MS	PRP
IVSUFF_DO:2P	PRP
IVSUFF_DO:3D	PRP
IVSUFF_DO:3FP	PRP
IVSUFF_DO:3FS	PRP
IVSUFF_DO:3MP	PRP
IVSUFF_DO:3MS	PRP
IVSUFF_DO:3P	PRP
PRON	PRP
PRON_1P	PRP
PRON_1S	PRP
PRON_2D	PRP
PRON_2FP	PRP
PRON_2FS	PRP
PRON_2MP	PRP
PRON_2MS	PRP
PRON_2P	PRP
PRON_3D	PRP
PRON_3FP	PRP
PRON_3FS	PRP
PRON_3MP	PRP
PRON_3MS	PRP
PRON_3P	PRP
PVSUFF_DO:1P	PRP
PVSUFF_DO:1S	PRP
PVSUFF_DO:2FS	PRP
PVSUFF_DO:2MP	PRP
PVSUFF_DO:2MS	PRP
PVSUFF_DO:2P	PRP
PVSUFF_DO:3D	PRP
PVSUFF_DO:3FP	PRP
PVSUFF_DO:3FS	PRP
PVSUFF_DO:3MP	PRP
PVSUFF_DO:3MS	PRP
PVSUFF_DO:3P	PRP

; PRP$
POSS_PRON_1P	PRP$
POSS_PRON_1S	PRP$
POSS_PRON_2D	PRP$
POSS_PRON_2P	PRP$
POSS_PRON_2S	PRP$
POSS_PRON_2FP	PRP$
POSS_PRON_2FS	PRP$
POSS_PRON_2MP	PRP$
POSS_PRON_2MS	PRP$
POSS_PRON_3D	PRP$
POSS_PRON_3FP	PRP$
POSS_PRON_3FS	PRP$
POSS_PRON_3MP	PRP$
POSS_PRON_3MS	PRP$
POSS_PRON_3P	PRP$

; WRB
INTERROG_ADV	WRB
REL_ADV	WRB

; WP
DET+INTERROG_PRON	WP
EXCLAM_PRON	WP
INTERROG_PRON	WP
INTERROG_PRON+CASE_DEF_GEN	WP
INTERROG_PRON+CASE_DEF_NOM	WP
INTERROG_PRON+CASE_INDEF_GEN	WP
INTERROG_PRON+NSUFF_FEM_SG+CASE_DEF_GEN	WP
REL_PRON	WP
REL_PRON+CASE_DEF_ACC	WP
REL_PRON+CASE_DEF_GEN	WP
REL_PRON+CASE_DEF_NOM	WP
REL_PRON+CASE_INDEF_ACC	WP
REL_PRON+CASE_INDEF_GEN	WP
REL_PRON+NSUFF_FEM_SG+CASE_DEF_GEN	WP
REL_PRON+NSUFF_MASC_SG_ACC_INDEF	WP

; VBD
PV	VBD
PV+PVSUFF_3MS	VBD
PV+PVSUFF_SUBJ:1P	VBD
PV+PVSUFF_SUBJ:1S	VBD
PV+PVSUFF_SUBJ:2FP	VBD
PV+PVSUFF_SUBJ:2FS	VBD
PV+PVSUFF_SUBJ:2MP	VBD
PV+PVSUFF_SUBJ:2MS	VBD
PV+PVSUFF_SUBJ:2P	VBD
PV+PVSUFF_SUBJ:3FD	VBD
PV+PVSUFF_SUBJ:3FP	VBD
PV+PVSUFF_SUBJ:3FS	VBD
PV+PVSUFF_SUBJ:3MD	VBD
PV+PVSUFF_SUBJ:3MP	VBD
PV+PVSUFF_SUBJ:3MS	VBD
PV+PVSUFF_SUBJ:3P	VBD

; VB (used for imperative here)
CV	VB
CV+CVSUFF_SUBJ:2FS	VB
CV+CVSUFF_SUBJ:2MD	VB
CV+CVSUFF_SUBJ:2MP	VB
CV+CVSUFF_SUBJ:2MS	VB
CV+CVSUFF_SUBJ:2P	VB

; CD
DET+NOUN_NUM	DT+CD
DET+NOUN_NUM+CASE_DEF_ACC	DT+CD
DET+NOUN_NUM+CASE_DEF_GEN	DT+CD
DET+NOUN_NUM+CASE_DEF_NOM	DT+CD
NOUN_NUM+NSUFF_MASC_DU	DT+CD
DET+NOUN_NUM+NSUFF_MASC_DU	DT+CD
DET+NOUN_NUM+NSUFF_MASC_DU_ACC_POSS	DT+CD
DET+NOUN_NUM+NSUFF_FEM_DU	DT+CD
DET+NOUN_NUM+NSUFF_FEM_DU_ACC	DT+CD
DET+NOUN_NUM+NSUFF_FEM_DU_GEN	DT+CD
DET+NOUN_NUM+NSUFF_FEM_DU_GEN_POSS	DT+CD
NOUN_NUM+NSUFF_FEM_PL	DT+CD
DET+NOUN_NUM+NSUFF_FEM_PL	DT+CD
DET+NOUN_NUM+NSUFF_FEM_PL+CASE_DEF_ACC	DT+CD
DET+NOUN_NUM+NSUFF_FEM_PL+CASE_DEF_GEN	DT+CD
DET+NOUN_NUM+NSUFF_FEM_PL+CASE_DEF_NOM	DT+CD
DET+NOUN_NUM+NSUFF_FEM_SG	DT+CD
DET+NOUN_NUM+NSUFF_FEM_SG+CASE_DEF_ACC	DT+CD
DET+NOUN_NUM+NSUFF_FEM_SG+CASE_DEF_GEN	DT+CD
DET+NOUN_NUM+NSUFF_FEM_SG+CASE_DEF_NOM	DT+CD
DET+NOUN_NUM+NSUFF_MASC_DU_ACC	DT+CD
DET+NOUN_NUM+NSUFF_MASC_DU_GEN	DT+CD
DET+NOUN_NUM+NSUFF_MASC_DU_GEN_POSS	DT+CD
DET+NOUN_NUM+NSUFF_MASC_DU_NOM	DT+CD
DET+NOUN_NUM+NSUFF_MASC_PL	DT+CD
DET+NOUN_NUM+NSUFF_MASC_PL_ACC	DT+CD
DET+NOUN_NUM+NSUFF_MASC_PL_GEN	DT+CD
DET+NOUN_NUM+NSUFF_MASC_PL_NOM	DT+CD
NOUN_NUM	CD
NOUN_NUM+CASE_DEF_ACC	CD
NOUN_NUM+CASE_DEF_GEN	CD
NOUN_NUM+CASE_DEF_NOM	CD
NOUN_NUM+CASE_INDEF_ACC	CD
NOUN_NUM+CASE_INDEF_GEN	CD
NOUN_NUM+CASE_INDEF_NOM	CD
NOUN_NUM+NSUFF_FEM_DU	CD
NOUN_NUM+NSUFF_FEM_DU_ACC	CD
NOUN_NUM+NSUFF_FEM_DU_ACC_POSS	CD
NOUN_NUM+NSUFF_FEM_DU_GEN	CD
NOUN_NUM+NSUFF_FEM_DU_GEN_POSS	CD
NOUN_NUM+NSUFF_FEM_DU_NOM	CD
NOUN_NUM+NSUFF_FEM_DU_NOM_POSS	CD
NOUN_NUM+NSUFF_FEM_PL+CASE_DEF_ACC	CD
NOUN_NUM+NSUFF_FEM_PL+CASE_DEF_ACCGEN	CD
NOUN_NUM+NSUFF_FEM_PL+CASE_DEF_GEN	CD
NOUN_NUM+NSUFF_FEM_PL+CASE_DEF_NOM	CD
NOUN_NUM+NSUFF_FEM_PL+CASE_INDEF_ACC	CD
NOUN_NUM+NSUFF_FEM_PL+CASE_INDEF_GEN	CD
NOUN_NUM+NSUFF_FEM_PL+CASE_INDEF_NOM	CD
NOUN_NUM+NSUFF_FEM_SG	CD
NOUN_NUM+NSUFF_FEM_SG+CASE_DEF_ACC	CD
NOUN_NUM+NSUFF_FEM_SG+CASE_DEF_GEN	CD
NOUN_NUM+NSUFF_FEM_SG+CASE_DEF_NOM	CD
NOUN_NUM+NSUFF_FEM_SG+CASE_INDEF_ACC	CD
NOUN_NUM+NSUFF_FEM_SG+CASE_INDEF_GEN	CD
NOUN_NUM+NSUFF_FEM_SG+CASE_INDEF_NOM	CD
NOUN_NUM+NSUFF_MASC_DU_ACC	CD
NOUN_NUM+NSUFF_MASC_DU_ACC_POSS	CD
NOUN_NUM+NSUFF_MASC_DU_ACCGEN_POSS	CD
NOUN_NUM+NSUFF_MASC_DU_GEN	CD
NOUN_NUM+NSUFF_MASC_DU_GEN_POSS	CD
NOUN_NUM+NSUFF_MASC_DU_NOM	CD
NOUN_NUM+NSUFF_MASC_DU_NOM_POSS	CD
NOUN_NUM+NSUFF_MASC_PL	CD
NOUN_NUM+NSUFF_MASC_PL_ACC	CD
NOUN_NUM+NSUFF_MASC_PL_ACC_POSS	CD
NOUN_NUM+NSUFF_MASC_PL_ACCGEN	CD
NOUN_NUM+NSUFF_MASC_PL_GEN	CD
NOUN_NUM+NSUFF_MASC_PL_GEN_POSS	CD
NOUN_NUM+NSUFF_MASC_PL_NOM	CD

.	.
"	"
NUMERIC_COMMA	,
,	,
:	:
;	;
-LRB-	-LRB-
-RRB-	-RRB-
NO_FUNC	NO_FUNC

PUNC	PUNC
PARTIAL	NOUN
TRANSERR	NOUN

